MMMMMMMMMMMMMMMMMMMM
MVVVMMVVVVVVVVVVVVVM
MVVBMMVVVVVVVVVWVVVM
MVVVMMVVVVMMMMMMMMMM
MVVVVVVVVVVVVVVHVVVM
MVVVVVVVVVVVVVVVVVVM
MVVVMMVVVVMMMMMMMMMM
MVVBMMVVVVVVVVVVVVVM
MVVVMMVVVVVVVVVWVVVM
MMMMMMMMMMMMMMMMMMMM