MMMMMMMMMMMMMMMMMMMM
MYYYMMYYYYYYYYYYYYYM
MYYBMMYYYYGYYYYWYYYM
MYYYMMYYYYMMMMMMMMMM
MYYYYGYYYYYYYYYHYYYM
MYYYYGYYYYYYYYYYYYYM
MYYYMMYYYYMMMMMMMMMM
MYYBMMYYYYYYYYYYYYYM
MYYYMMYYYYGYYYYWYYYM
MMMMMMMMMMMMMMMMMMMM