MMMMMMMMMMMMMMMMMMMM
MXVVMMVVVVVVVVVVVVVM
MVVBMMVVVVVVVVVWVVVM
MVVVMMVVVVMMMMMMMMMM
MVVVVVVVXVVVVVVHVVVM
MVVVVVVVVVVVVVVVVVVM
MVVVMMVVVVMMMMMMMMMM
MVVBMMVVVVVVVVVVVVVM
MVVVMMVVVVVVVVVWVVVM
MMMMMMMMMMMMMMMMMMMM