MMMMMMMMMMMMMMMMMMMM
MXYYMMYYYYYYYYYYYYYM
MYYBMMYYYYGYYYYWYYYM
MYYYMMYYYYMMMMMMMMMM
MYYYYGYYXYYYYYYHYYYM
MYYYYGYYYYYYYYYYYYYM
MYYYMMYYYYMMMMMMMMMM
MYYBMMYYYYYYYYYYYYYM
MYYYMMYYYYGYYYYWYYYM
MMMMMMMMMMMMMMMMMMMM