MMMMMMMMMMMMMMM
MVVVVVVVVVVVVVM
MMMMMVVVVVVVVVM
MMMMMVVVVVVVVVM
MVVVVVVVVVVVVVM
MVVVVHVVVVVVVVM
MVVVVVVVVBVVVVM
MMMMMMMMMMMMMMM